1111111111111111111111111111111111
1E111111111111111111111111C11111P1
1111111111111111111111111111111111
