1111111111111111111111111111111111
1E000000000000000000000000C00000P1
1000000000000000000000000000000001
1111111111111111111111111111111111
