1111111111111111111111111111111111
1E000000000000000000000000C00000P1
1111111111111111111111111111111111
