1111111111111111111111111111111111
10P000000000000C00000C00000000E001
1111111111111111111111111111111111
