1111111111111111111111111111111111
1EP00000000C0000000000000000000E01
1111111111111111111111111111111111
